name	prefix	repeat	suffix
HMNR7	GCGTGGGCGTGGCCTCGGCGTGGGTGTGGCCGCTCGGGGAGGGGCCTCCCGGGGGCGGGGCCGGCCTGGTCCGCGCGGTGACGCGCCCTGCAGCCCCGAGCGAGCGAGCGAGCGAGCGAGTTGCCGAGCGCGCCCCGTCCCTCGCGCGCGATGCTCCCCTGGACGGCGCTCGGCCTGGCCCTGAGCTTGCGGCTGGCGCT	GGCGCGGAGC	GCGGTGAGTGCGGCGGGCGGCCGGGCCGGGGCTGGGGCTTCTGGTGACCGCTCTGCGCCGCTGCCCGCGCAAGGCCGTCGCTGTCCCCTGCTCCGGACGGGCGGGCGGGCTGGGAGGCTGCGGGAGCCGGGCGGGGGCGCGGGCGGAGCGTCCTGCTCACCTGAGGCTGGCGGCCCAGGTGCTCCAGGCGACACCGTCCG
SCA37	ACCTCCATGCTGTTCTGAATATCTCTTAGCAAAGCTGGAAAGAATGAAGCCCAGGAATGTAAACTGACTATATAAATCACACAAGGCCAGGCACAGTGGCTCACACCTATAATCCCGACACTTTGGGAGGCAGAGGCAGGTGGACCACTTTAGCCCAGGAGTTCGAGACCAGCCTGGGCAACACAGTGAGACCCTGTCTC	AAAAT	CAGGCATGGTGCCATACATCTGTAATCCTAGTTACCTGGGAGGCTGACTTGGGAGGACCACTTCAGCCAGGGAGGCTGAGGCTGCAGTAAGCTGTGATGGCACTACTGCACTTCAGCCTGGGTAAAAGAGCATGACCCTGTCTCAAAAAAAACAAAAAAAAGTCACACAAAATGGTACTCTGAAAAAAGTAAGAGTTCGG
NIID	CACCCGAGAAAGTTTCAGCCAAACTTCGGGCGGCGGCTGAGGCGGCGGCCGAGGAGCGGCGGACTCGGGGCGCGGGGAGTCGAGGCATTTGCGCCTGTGCTTCGGACCGTAGCGCCAGGGCCTGAGCCTTTGAAGCAGGAGGAGGGGAGGAGAGAGTGGGGCTCCTCTATCGGGACCCCCTCCCCATGTGGATCTGCCCA	CGG	ACCGAGAAGATGCCCGCCCTGCGCCGCTCTGCTGTGGGCGCTGCTGGCGCTCTGGCTGTGCTGCGCGACCCCCGCGCATGGTGAGTATCGGGCTGAGGGGCGCTGTCCGCGGCGCCCGGGGCTGCCACCTGGGGCGACCCTTCTCCCCCTCGGTCCTTCTCTGTGTGGGAAGGCCAGGCTCGGCCGCCGGCGCGGAGCGA
FAME2	ACCAGCCTAACCAACGTGGAGAAACCCTGTCTCTACTAAAAATACAAAATTAGCTGGGCACGGTGGCACATACCTGTAATCCCAGCTACTCGGGAGACTGAGGCAAGAGAATCGCTTGAACACGGGAGGCGGAGGTTGCAGGGAGCCAAGATCGTGCCATTGCACTCTAGCCTGGGCAACAAGAGCGAAACTCCGTCTCA	TAAAA	GCCAAGCACAACGGCTCACGCCTGTAATCCCAGACTTTGGGAGGCCGAGGTGGGCGGATCACCTGAGGTCAGGAGTTCGAGACCGGCCTGGGAAACATGGTGAAACTCCATCTCTACTAAAAATACAAAAATTAGCTGGGCATGGTGGTGGACGCCTGTAATCCCAGCTACTCGGGAGGCTGAGGCAGAAGAATCACTTG
FRA2A	ATTCCTGGAGCAGGGCTAAGTCGAAGCTGTCCATGGTGGGAGGTGTCAGCGTCGCCGCCGCCGCTACCGCCGCCGCCGAGGCTCGGGCCGCCCGCGCGCTGCAACGAAAGGCGCCGCTCAAGGTGCATCCCAGCCGCGCCAGAGCGGCCGCCGCCCGCCCACCGCCCACCCCCAGGTCGGGGCTCCCGACGCCCCCCGCC	CCG	CGGGAGGCGCGTGTGCGCGGGCGAGGCCGAGGCGCGCGCGCACCGTGAGCCCCGCGCCGCGCCCGCCCCGCGCGCCCCTGTACTCCCCGCGCCGCTCCTCGGGGTCCCGCGGCGCTCGCAGGCCGCGCCGCCCTGCCGCCCCTCTCTCGTGGCTTTTACGGCCCGCCCGCCCCTCAGCAGCCCTGGGGTGCCCGGGGCGG
SPD	GGCCAGGGCCGGGGCCGGGCCAGGCCGGGCCATGAGCCGCGCCGGGAGCTGGGACATGGACGGGCTGCGGGCAGACGGCGGGGGCGCCGGTGGCGCCCCGGCCTCTTCCTCCTCCTCATCGGTGGCGGCGGCGGCGGCGTCAGGCCAGTGCCGCGGCTTTCTCTCCGCGCCTGTGTTCGCCGGGACGCATTCGGGGCGGG	GGC	TCCGGCTTTGCGTACCCCGGGACCTCTGAGCGCACGGGCTCTTCCTCGTCGTCGTCCTCTTCTGCCGTTGTAGCGGCGCGCCCGGAGGCTCCCCCAGCCAAAGAGTGCCCAGCACCCACGCCTGCAGCGGCCGCTGCAGCGCCCCCGAGCGCTCCAGCGCTGGGCTACGGCTACCACTTCGGCAACGGCTACTACAGCTG
GAD	CCGCGCACCCAGAGCCGAGAGAAATTTGACTGCCCTAATCGCCAATCAAAAGAGAGGTCGAGGATTTGAGCCAATCGCAGCGGGCGAAAGGGGCGGGCCGTCGGCGAGCGCTGAAGGTCTCTAGCCCTCCCCTGCGCTTTAGCCTCAGTGCGGAGCCTTAGGCGGAGCGAAGAGAACCGGTCGCGGCAATCCTAGCGCGC	CAG	ACCCGCATCCGCTGCGGGAGTCCGAGCCGGAACCACACCCAAGTAGCTGCCCTTTCCTCTTCTGTCATCTCACCGCCCCACCACAGACCGCGTTCCCCGAGGAAACCGGCCGCCCACGCCCGGAGCATCCTCCCCTGTTGAGCGGGCGCTGACGGACCCGGCGGCATGATGCGGCTGCGAGGCTCGGGGATGCTGCGGGA
AD	GATCACTCGCGGTTAGGAGCTGGAGACCAGCCCGGCCAACACAGCGAAACCCCATCTCCACCAAAAAAAAAACGAAAACCAGTCAGGCGTGGCGGCGCGCGCCTGCAATCGCAGGCACTCGGCAGGCTGAGGCAGGAGAATCAGGCAGGGAGGTTGCAGTGAGCCGAGATGGCAGCAGTACCGTCCAGCTTTGGCTCGGC	GAGAGG	GTCAAATTCTTATCTATCAATGTTATGCCCACTGTGCTCTCCAGCTGTGGTCTGTGAATTACTGTGGTATAACGTGACTGTTCAAATTTCACTTTTCAGGGGCTTTGACCACGACCTTTGAAGAGCTTCATTTTGAGATCAAGCCCCACGATGACTGCACAGTAGAGCAAATCTATGAGATTTTGAAAATCTACCAACTC
SCA7	CACCCGGTCCGCGGGCCGCGCACGCCGCCGGAACTCCCTGGCGCCTCCTTAAAAAACGGCCCCCGCGCGACTCTTTCCCCCTTTTTTTTGTTACATTGTAGGAGCGGAAAGAATGTCGGAGCGGGCCGCGGATGACGTCAGGGGGGAGCCGCGCCGCGCGGCGGCGGCGGCGGGCGGAGCAGCGGCCGCGGCCGCCCGGC	CAG	CCGCCGCCTCCGCAGCCCCAGCGGCAGCAGCACCCGCCACCGCCGCCACGGCGCACACGGCCGGAGGACGGCGGGCCCGGCGCCGCCTCCACCTCGGCCGCCGCAATGGCGACGGTCGGGGAGCGCAGGCCTCTGCCCAGTCCTGAAGTGATGCTGGGACAGTCGTGGAATCTGTGGGTTGAGGCTTCCAAACTTCCTGG
DM2	TTGAGACCAGTCTGGCCAACATGGCGAAACCCCGTCTCTACTAAAAATACAAAAAACAGCCGGGCATGGCGGCATGCGCCTGTAATCCCAGCTACTCAGGAGGCTGAGGCAGAAGAATCGCTTGAACCCGGGGGGTGGAGGTTGCAGTGAGCCGAGATCATACCACTGCACTCCAGCCTAGGGGACAAAGTGAGACAGAC	CAGG	ACAGACAGACAGACAGACAGACAGACAGACAGACAGACACACACACACACACACACACACACACACACACACACTGGCAGTAATACTCATTCACTCATTCCAAGTCCAACTTAATGGACACATTTGCATGGTTATAAGGCCTATATAAGCTTTATTTTGGGCAAATAGAAGTCATTTATTTACTCACATCAAAAAATTGG
BPES	CGTGCAGATGGTGTGCGTGCGGATGCGGGTGGGGGTGCGGCGGAGGCGGGGGTGCGGCCGGCGGGCCTCCCAGGCCATTGTACGAGTTCACTACGCCGGGGGGCAGCGCCATGCTCTGCACGCGTGTGTACGGCCCGTACGAGGCGGCCGGGCCCGCCAGCCCCTTGACCACAGCGGCCGCGCCAGGGCTACCGGGGCCC	GCN	CATCTGGCAGGAGGCATAGGGCATGGGTGAGGGAGGCTGCGGTAGCGGCCACGAGTTGTTGAGGAAGCCAGACTGCAGGTACTTGGGGGGCGCCAGGTAGCCGTAGCCGTCGGCCCCGGCGCCCGCCACGCCGCACCCGCCTGCGGCGCCTCCGGCCCCGAAGAGCCCCTTGCCGGGCTGGAAGTGCGCGGGCGGCGGCC
FAME4	TCTGGCTAATTTTTGTATTTTTAGTAGAGATGGATTTTCACCATGTTGGCTAGGCTGGTCTCGAACTCCTGACCTCATGATCCGCCTACCTTGCCCTCCCAAAGTGCTGGGATTACAGGCATGAGCCACTGCACCCGGCCTAAATTGTTATTTTTGTTTTAACTTTGAGTGAATACAAAATGAGTATTTTTGAGTTAGCA	ATTTT	TTGAGACAGAGTCTCACCCTGTCTCCCAGGCTGGAGTGCAGTGGTACAATCTCGGCTCACTGCAACCTGCCTTCTGGGTTCAAGCGATTCTCATGCCTCAGCGTCCTGAGTAGCTGGGATTACTGGCATGAGCCACCATGCCCAGCTAATTTTTTTGTATTTTTAGTAGAGACGAGGTTTCACCATGTTGGCCAGCCTGG
CANVAS	AGCTTGGCCAATATGGTAAAACCCCATCTCTAGGAAAAATACAAAAAATTAGCTGGACATGGTGGCACGCGACTATAGTCCCAGCTACTCAGGAGGCTGAGGCAGGAGATTCACTTGAACCTGGGAGGCAGAGGTTGCAGTGAGCCGAGATTGCGCCACTGCACTCCAGTCTGGGCAACAGAGCAAGACTCTGTTTCAAA	AAAAG	AAAAAGCATGTTCTAAAGAGAATAGCAACGGTGTAGCTGGAGTATCACTTGATAAAGAGATTATGGGATTATACAGGCAAAAACACTGTCAGTTTGAATTGAAGAGGATGGAGAAAGGACAAAATGAAAGAAGGCTGTCAGACTTCTGAGATTCCAGTGACAGGACAACACAGCTATTCTTCAAGAAAAGGGAAGAATGG
CCHS	GTCGCCGCCGCCGCCGCCGCCGCAGGATTCCAGATCAGAACATACTGCTCTTCACTAAGGCGGCTTTGGCACCGTTGGGTCTTTGGAGCGAAGATAGGACGCTGGCGAAGGGACCCCCAAGCGAATCCGGGATGGAGGTGATGGGGCCGGGGCCGGGAGCCCAGCCTTGTCCAGGGCCCCCAGCCGCAGCCAGGCCTCCA	GCN	GCCGCCCTTGCCGGGTTCGCCTCCCGGGCCCCCGGGCCCCGCCGCCCCCGGAGCTCCAGCCGGGCTGGGCCCGCCGCCGCCGCCTCCATTCGCCCCGCAGCTGGGGGTGGGGTTGGGATTGGGACCTGGGCCCCCAGTGCTGTCCGGGTCAGTGCTCTTGGCCTCTTTGCTCTCGTCGTCCCTGGAAGAGTCAGACTTTT
FAME7	GTGTGTGGAGTTCCATCAAATAGCACAAAGCAGATGGCCGGGAAATGTTAATTTTCTTCCCTTTTTTTAAGAGCTTAGATTGAGGTTAGAAGAAAAAAAAATGGCAACAATTAGTTATATTGATGTTGAGGGTGATTATTAAATTAGTCATTTTCTCTGTCTGGGAGTTTAGTCATACTCTCATTACTATCATAGCTTTT	TTTTA	TAGAGGATATTTGCTCAGTCGGTTTTATCAAATGGCCGCTATGGGCTAAGCACTGCTATGTGTACATACTGCTGTGTATGGAAACAAAGCATCAATACTTACATTCAGGTGGTTTTACTGATAGTAAACAGATGAGGTAGGTCTATACGGAAGAGAAGAGTAAAACGCCTTGGCTTGACCCTGACCCTACTTCCCTGTGC
FAME3	AAAAAACTAATAAAAAATGTTCTATTTGTGAAATCAGTTATTATAGGTTATTTCTTTAAAAAATGCGACTTAGGTTTTTTAAATCTGCTTAGAAATTTTTTGGTAGGAGATATTCAAAGTATGGCCAAACATAAAACTAAATTAAAAAAAAATCAGTATCACCTACTTTTGAAAACACTTATACTGTTGTGGTTCTGTTT	TTTTA	CCGAGATGGAGTCTTGCCCTGTTGCCCAGGCTGAAGTGCAGTGGCATGATCTCTGCTCACTGCAACCTCCACCTCCCAGGTTCAAGCGATTCTCCTGTCTCAGCCTCCTGAGTAGCTGGGATTACAGGAGCGCGCCACCTCCCTCTGCTAATTTTTGTGTTTTTAGTAGAGATGGGGTTTCGCCATGTTGGCCAGACTGG
SCA12	ATGGTGCCTTTCTGGACCCGAGCTGCAGTGGCGAGATGGCAGGGACAGGATTCAGGCTTGCCTGGCCGGAATGAGGGTGCTGGTCCCACGGGAGGGCGGCTCCGGCAGGCGGGGGTAGGGAAGCTGGCGGGGAGCTGGGCAGGGCGCTGCAGCCGGCGCCAGCGCACTCACCCTCACACCCACACGCGCGCACTCGCAGC	CTG	CAGGAGGCTGGAGGCGGCTGGTGCATTAAAGGCGAGGCTCCTCCCAACCGCGTCAGCAGCCCCACGACTCTTTCCCAGCAGCAGTGGTGGCCGAGGCAGAGGCTGCGGCTGCTCTTTGCTGCAGTGGGGCGCATGCAGCCGCGAATCGGCACCTGGGCAGCAAGCGACTAGCTTGCAGGTTCAGGTGGAACGCATAGACG
SCA1	TTGCATGACGACCTGGGAGGGGGGCCCCAGGGTGAGCGTGTGTGGGATCATCGTCTGGTGGGGGTGGAGGTGGACGGGGATGGCCGGAGGAGAGGCGGTGCGGCCGGTGTTCTGCGGAGAACTGGAAATGTGGACGTACTGGTTCTGCTGGGCTGGTGGGGGGGACCCCGGGGTGATGAGCCCCGGAGCCCTGCTGAGGT	CTG	CAGCCTTGTGTCCCGGCGTCTGGCTCAGACTGCCCATGTTGGCCAGCAGAGTGGAATAGGCCTCCAGCTGGGAGCGCTGGGATGGAGTGGTGGCCCCTGCGGCCGAGGCCACTGCACTGGTGACGGGGTTGGCGGTTGGGGGGATCAGCTGTGATGGGATGAAGCTGGCATAGGTTCCACTGTATTGGGAGGACCCAATG
CCD	ACTTCGCTAACTTGTGGCTGTTGTGATGCGTATTCCCGTAGATCCGAGCACCAGCCGGCGCTTCAGCCCCCCCTCCAGCAGCCTGCAGCCCGGCAAAATGAGCGACGTGAGCCCGGTGGTGGCTGCGCAACAGCAGCAGCAACAGCAGCAGCAGCAACAGCAGCAGCAGCAGCAGCAACAGCAGCAGCAGCAGCAGGAGG	GCN	GTGCCCCGGTTGCGGCCGCCCCACGACAACCGCACCATGGTGGAGATCATCGCCGACCACCCGGCCGAACTCGTCCGCACCGACAGCCCCAACTTCCTGTGCTCGGTGCTGCCCTCGCACTGGCGCTGCAACAAGACCCTGCCCGTGGCCTTCAAGGTAAGAGGCTACACCGCCCCCCGCCCCCGGCCGGGAGCGGCGGA
SCA17	CCTGACCTGCTGTTCCACCAAGAAAGTTCCACAAACACTTAGCAGCAGCCAGCCTAACCTGTTTTTCTCCTTGCTTTCCACAGGGTGCCATGACTCCCGGAATCCCTATCTTTAGTCCAATGATGCCTTATGGCACTGGACTGACCCCACAGCCTATTCAGAACACCAATAGTCTGTCTATTTTGGAAGAGCAACAAAGG	CAG	ACAGGCAGTGGCAGCTGCAGCCGTTCAGCAGTCAACGTCCCAGCAGGCAACACAGGGAACCTCAGGCCAGGCACCACAGCTCTTCCACTCACAGACTCTCACAACTGCACCCTTGCCGGGCACCACTCCACTGTATCCCTCCCCCATGACTCCCATGACCCCCATCACTCCTGCCACGCCAGCTTCGGAGAGTTCTGGGA
FRA7A	GAAGGAAGCAGGCTCGGAGCGCCGCCAGCGCATGCGTATTGGGGATCTGAGGCCAGCGTCTTGCGCCGCCATTGCGGGGAGGCTGTCCTCAGAGCAGGTCTGGCGCGCCGGTGGCTGGACCGGCCCCAGGAGCCCAGTCACCGGGCGTCATTGGCTCAGGCTGCGGGGCCCTCGGCACCTTCTCCCTCCCGGGTCCACCG	GGAGGCG	TGTCCCCGCTGTCCCCATTCCTGTCACCCGCCCCGTGTCCCTTTCAGATTTTTGGTCTTTTATAGGAAGGTCTTACCCGTTCCAATATTATAAACACATTGTCTTCTACTATCTGGGAATGACTCTGAGGCTGAAGAAAAACTTGCAGTTTATTTTTGGGCAAGCGTCCATAGGTGTCATTTTGGGGGAAAGTTTTTCCT
OPDM1	CGGGTCGCCTCAGCTTTGTTCGGTCAGCGGGGCGCGGGGACGCGGACACTTACCGTACACCCCAGCGAGGAAAAGCAAGAGCAACGCAGACCTCCACCGCGGAGACTCTTTTGTGCTCCAGCGACAGGCCATAACCACAGCAGATGGAGAGAGAGAGGAGGAGACGGAGGAGGAGGGAGGAGAAGCTGGAGGTAGACGAC	GCC	AGCCACCGGCTGCTCCCTGCGCTCTCCGCGGCTGCGGGAGGGGGAAGGGAGGGGCCGCCGCCGCCCGCGCGCGCTCCCTCCTCCCTCCTCCCTCCGGCTCGCCTGCTCCCACCCCGGGCGGTGCGAGAGCCCCACGCGGGGCGGCCCTCCTGGGGGCAAGGGCAAGGAGCTCGCGCGCCAGCGCGAGACGAGAGGGTGGC
FAME1	ACCAGCCTGACCAACATGGTGAAATCCCGTCTCTACTAAAAATACAAAATTAGCTGGGCGTGGTGGCACATGCCTGTAATCCCAGATACTCAGGAGGCTGAGGCAGGAAAATTGCTTGAAACTGGGAGGCGAAGGTTGCAGTGAACCCAGATCGCGCCATTGCACTCCAGCCTGGGCAACAAGAGTGAAACTCTGTCTCA	AAATA	ATGAACAAAATGAAAAGGGGGATACTAAGAATGGAAGTATTATTTCAGAGAAGGATAAGGATAGAAGGCTTTATTCTTGTCTGGGGCTCAAGACTGGACCAATGGCTGCACAACTTTAGAGTCCATTCACAGTGTAGTCTATGCACATGGTACCTTCTAGAATTGGCATGTAGAAATTCTGATACAATGGGAGGCTTGAA
ALS.FTD	CCCGACACCCAGCTTCGGTCAGAGAAATGAGAGGGAAAGTAAAAATGCGTCGAGCTCTGAGGAGAGCCCCCGCTTCTACCCGCGCCTCTTCCCGGCAGCCGAACCCCAAACAGCCACCCGCCAGGATGCCGCCTCCTCACTCACCCACTCGCCACCGCCTGCGCCTCCGCCGCCGCGGGCGCAGGCACCGCAACCGCAGC	GGCCCC	TAGCGCGCGACTCCTGAGTTCCAGAGCTTGCTACAGGCTGCGGTTGTTTCCCTCCTTGTTTTCTTCTGGTTAATCTTTATCAGGTCTTTTCTTGTTCACCCTCAGCGAGTACTGTGAGAGCAAGTAGTGGGGAGAGAGGGTGGGAAAAACAAAAACACACACCTCCTAAACCCACACCTGCTCTTGCTAGACCCCGCCCC
FA	CTTTGGGATTGGTTGCCAGTGCTTAAAAGTTAGGACTTAGAAAATGGATTTCCTGGCAGGACGCGGTGGCTCATGCCCATAATCTCAGCACTTTGGGAGGCCTAGGAAGGTGGATCACCTGAGGTCCGGAGTTCAAGACTAACCTGGCCAACATGGTGAAACCCAGTATCTACTAAAAAATACAAAAAAAAAAAAAAAAG	GAA	ATAAAGAAAAGTTAGCCGGGCGTGGTGTCGCGCGCCTGTAATCCCAGCTACTCCAGAGGCTGCGGCAGGAGAATCGCTTGAGCCCGGGAGGCAGAGGTTGCATTAAGCCAAGATCGCCCAATGCACTCCGGCCTGGGCGACAGAGCAAGACTCCGTCTCAAAAAATAATAATAATAAATAAAAATAAAAAATAAAATGGA
HSAN8	GCCAGTCGTCCACGCTGCGCAACCACGTGCGCCTGCACACGGGCGAGCGCCCCTACAAGTGCCAGGTGTGCCAGAGCGCCTACTCGCAGCTGGCCGGCCTGCGCGCCCACCAGAAGAGCGCGCGGCACCGGCCGCCCAGCACCGCGCTGCAGGCACACTCGCCCGCGCTGCCCGCCCCGCACGCGCACGCGCCCGCGCTC	CGC	GCGCACCACCTGCCGGCCATGGTGCTGTGAGCGCGCCCGCGCCCCCGCCGGGCCCCGCGCGCTCCTGGGTCCCCGGCACCCCGGCCCCGCAGCGCGACTCGCCCTCCAGCCCCAACCCCCGGCCCGGCGCCGCCGCGGAGCCCCGCGCGCTGGGGTTGCGCCCCGGAGGCGGATCTCAGGCACCCCCGCCTTGGCCCGTG
OPML	CCGGCGGGCAAGGCGGCGGCGGACCGAGGGAGGCCTGGCCCGGCAGCGGGGAGAAGGGTGCGGCGCAGCCCGAGTTTCCCACCTTTTATCCTGGCCCAGACGCGGCTGGGGCGGACGGGACCTCTCGCGCTCTGCCTCCTCCTCTTGCTTCATGGAGCCATGCGCCTGGGTGGGGGCTCCCGAGAGAAGCTGGCCTGCGG	GGC	CGGGAAGAACTAGAGGTATTCCCCGGGCGGCTGGAGGACTGAGTCGAGCCGGGACCCGAGTCCTCCGGTATCCCAGCAGCCACCGGAGGCAGTGAGGTAATGGAGGAAGAATGTAGGGAGTCCTCCGGTGGACCACACTCCTTCTAGCGAGCCGCGGAAACCATAGAGATCAGGGCTCAGCCGGAGGGCCGGCCCACTGC
FRA11B	CGAAGCCGGTGGCCCGGGGATCGTCGCTGCCCAGTCCGGCCGCGGCCGGCCGCTTCCCCGAGCTTACCAGTAAGCCGGTCCGCCTCCGGGACGCGCCCCGCCCGCCCCGGGCTCGCGCGCTCTGAAGGGGCGCGTCCCGCGCACTCCCGGCGCCGCCCACTCCCCTCCCCACGGCCGCTCCTCCCTCCGCCCGGATAGCC	GGC	CGGGAGAGGCCCCTCCTTCACGCCCTGCTTCTCTCCCTCGCTCGCAGTCGAGCCGAGCCGGCGGACCCGCCTGGGCTCCGACCCTGCCCAGGCCATGGCCGGCAACGTGAAGAAGAGCTCTGGGGCCGGGGGCGGCAGCGGCTCCGGGGGCTCGGGTTCGGGTGGCCTGATTGGGCTCATGAAGGACGCCTTCCAGCCGC
FRA12A	GTGGTAAAGCCGACAGTCCATACCATGAGCCCATTTCGCGCAGGGAAATTCGAGTGGTGGGCTTGGGCCCGTCGTTCTGGTAGCTTCCCAGTAGAGGGCGCCGTAAGCATATGCGTCTTCAGCCTGACTGGGCTGGAGAGGCGGTGCGTCCTCCTGGCCGGGGGGCGGGGGCCGTCGCGCTCACGTGACCTTTGCTCATG	CGG	ATCCTGTAGCCGGGTGTGGGCCCGTGTCTGTCCGTCCCTCCTTCGGCCCCCTCTCTTGTCTTCCGGAGTGTGGCTGGCGGAGCTGGGATGGCGGAACGAGGCCTGGAGCCGTCGCCGGCCGCGGTGGCGGCGCTGCCGCCTGAAGTGCGGGCGCAGCTGGCGGAGCTGGAGCTGGAGCTCTCGGAGGGTAGGAGCCGGGC
SCA2	GGAGCGGAGGGGGCTGGGGTGCCGACACCCACCTGCCCAGGCCGGGCCTCCCGCCGCCGGAGGTCGCCGCGACCACCGAGGAGGGAGCCGTGGCCGAGGACGAGGAGACCGAGGACGAGGACGGCGAAGGCGCGGCGGCGGGCGACGCTAGAAGGCCGCTGCCGCCGGGCTTGCGGACATTGGCAGCCGCGGGCGGCGGC	TGC	GGGCTTCAGCGACATGGTGAGGGGCCCATACACCGGCTCGCACGCCGGGCGGGGACAGCCGGGAGCCGGGCGCGCCAAGGAGACGCCGGAACGCGGCGGGGACGCGCGGGCGCCGAGCGGGGAGGCGCGGGTTGGCGCGGCCGGAGGGGCGCCCGGGCTGGCGAGGGGGAGAAGGAGGACGACGAAGGGGCGGGGAGGCC
OPMD	GGCAGATTTCCCCTACCGGGATTTGAGAATTTGGCGCAGTGCCCCGCCTTAGAGGTGGGGCCTTATTTGATTGCCAAGTAATATTCCCCAATGGAGTACTAGCTCATGGTGACGGGCAGGCAGCTTGACTAATGAGTCCTCGGCGTGGCCGGCGCAGCTCTCCAATCGCCGGGCGGCGGGCCCCAGTCTGAGCGGCGATG	GCG	AGCAGCAGCGGGGGCTGCGGGCGGTCGGGGCTCCGGGCCGGGGCGGCGGCGCCATCTTGTGCCCGGGGCCGGTGGGGAGGCCGGGGAGGGGGCCCCGGGGGGCGCAGGGGACTACGGGAACGGCCTGGAGTCTGAGGAACTGGAGCCTGAGGAGCTGCTGCTGGAGCCCGAGCCGGAGCCCGAGCCCGAAGAGGAGCCGC
SCA3	CTTAAGATTCTTAATATGATTAAAGAGGGAATGAAGAATAATGTAAAGCAAAAATCACATGGAGCTCGTATGTCAGATAAAGTGTGAAGGTAGCGAACATGATGAATGGTGAGCAGGCCTTACCTAGATCACTCCCAAGTGCTCCTGAACTGGTGGCTGGCCTTTCACATGGATGTGAACTCTGTCCTGATAGGTCCCCC	CTG	TCTGAAACATTCAAAAGTGAAGTATATTTAAAAAACAAAACTTAAAAGAATAAATACACCATGAGAAAAACTATTCATAAGGAAAATACATTGTTTCACGAATCAAAGTAGTCACTGGTATTAAAAGAATGCAAGAGCAGTTAGTCTGATACAGATTACTTTAAAATATGGAAGTGCTGATCTTAGGAAATCTAGACATA
ALS	TGCTGTCCCCGCAGCCTAAGGCGCCGGTCCCTGGCACCCCCGTCCCGCCCCCGCCCCTCTTCCTGCTCCTCCCCCACCCGTCCCCCTCCCCTCCCCCGCCCGCGCCTCCCGGTCACCCCCCATCCCGCCCCGCGGGGCGCGGCGCGCAGGCGCAGGCTCGGAGGGCGGGCGCGGGCGGAATGGGGACTGCAGCTGCGGCA	GCG	GCCGGGGAGGGGGCGCGTAGCCCGAGCCCCGCCGCCGTGTCGCTCGGCCTGGGCGTGGCCGTCGTGTCGAGCCTGGTGAACGGGTCCACGTTCGTGCTACAGAAGAAGGGCATCGTGCGTGCCAAGCGGCGAGGTAGGGCGGGCGGCAGGCGGCAGGCGGCGGGCGGGTGGGGGAGGCGGGCGGCGGAGAAGGCGGTCGC
FAME6	TAGTCCCAGCTACTTGAGGGGCTGAGGTGGGAGGATCACTTGAGTCTGGGAGGCAGAGGTTGCCGTGAGCCAAGATAATGCCACTGCACTTCAGCCTGGGCAACAGAGCAAAACCCTGTCTTAAAAAATATATATTTTGCATATTGATTCATGTTAAAAATATGCAGAATCATTACTATTGATTTGTATTATGAAATGTT	TTTCA	TTCAATGTAAATTCTTATACTTTTCCAGCTAGGTCACAGGTTTTTCTTTCTTTAGAGCTTGGAATTTATCTCATTTCATATACACTATGATATTGCTGAGAAAACTTAAGTCACACTGCCATGTTTATCTTTGATTATTAAATATTTGGCAAGCATTCCCTTTGTTTCAAGAAAATCTTGAATTGGAATTGACAGTACAG
SCA31	GATCAGCCTGGCCAACATGGTGAAATCCCATCTCTACTAAAAAAAAAAAAAAAAAAAAAAAAAAAAATTAGCCAGGCATAGTGGCACATGCATGTAGTCCCAACTACTTGGGAGGCTGAGGCAGGAGAATCGCTTGAACCCAGAAGGTGGAAATTGCAGTGGGCCAAGATCACGTCACTGCACTCCAGCCTGGGCAACAA	AATAA	GATGTGCCTGGTCTTCATTTTTTGTGGGGCAGGGGGACAAAGAAAGGACAAATCCTGACCTAGGCCCTGCTCCACTGGGAGGGGCCCGGTCACCCTCCAATCTCAGCTTTTCAGAGTGACAAGCAGTGGCAGGGCCTGGCTGCACATAGCTTTATCTCTTGCTAGCACAACTTCCTCCTTTGCTTCCAGATTGGGCTTTG
HDL2	TCTAGGTGGTTGGACGCGGACTAGCGCTGTCGAAGCAGGCTGCTGGAGGGAGGAGGGAGGCCCATCTGCTCAGTGAGAGCCCAGGAATCTCGTCTTTCAGTGGCTGCATCGTTTTCACCATTAGTTGAGGGAATCGATCTGTGCCTTCATTCTAAGATGCCACCGCATTCGGGGCAGAGCCGGGGCCGGAAGCCAGGGAG	CTG	TAAGATGGTTTCTGTGCAGGGAACCTTGGCCGGCTCTGCAGCTGCCCGCCTGCCTGGACTCTCCGATATCCACTCCTCAGTGCACCTGACACGCATGGAGCCGGTCCTTTCCTGGAAGCCAGACCCCAAACAAACTGGCTTCCCCGACCAGTCCACTCCCATGTGGGAGCTTATCCTCAGAGGCACTGGGTCCTCTGCCT
RCPS	CACCTCCTCGCTGGTCTCGAATTCCACTTTAGTCATGTCTTCCTCTTTGAGCAGCCGCTTTCGCGCCGAGCCCGAGGTCGCCATCGTGGCCGTGGTCGCCATGATTCAGAGTCCGCGGAAGAGCACAGCGCGCGCCGCTGCCGACCTCGCTGCCGCTGCCGACCTCGCTGTGCCGCTGCCGACCTCGCTGCCGCTGCCGA	GCCGCTGCCGACCTCGCTGT	GAACAGACGCCTTAAGTATGCGAAAGCGAGAGACGTGCGTGCGTACGTGCGTACGTGCGTACGCGCGACGCGGCCACGCCTCTGGGGGACGGGGCACTCTTCGTCACGTGAAAGGGAACTGGGCGTTTGCCGCAGGGAAAAGTAAGGTGTTTCTGCTCTCGCGCCATATGCAGTTCCCGCGGGATCTCGTTGAGGGCGGG
FECD	CTAGTGGATAATGCACACCTTCCCTGAGTCAGAGCCTGCAAAAAGCAAAGGAACGAATGGAGAAAGTGCAACAAGCAGAAAGGGGGCTGCAAAGCTGCCTGCCTAGGGCTACGTTTCCTGGCAAAACTTCCGAAAGCCATTTCTCCAAAAGAAGGTCTAGAAGAGGAGGAGGAGGAGGAGAAGGAGGAGGAGGAGGAGGA	GCA	TGAAAGAGCCCCACTTGGAAGGCGGTTTGGATTTTATTTGTGTGTTTTGTGGATTCTTTTTATTTTGCTTTACAAATGCATCTTACACCAAACTCATCTGGCATTAAAAATGAATTCATTCTCCTGACATGTCTGGGACTTGGTTTAGGAAAAGGAAGCAAAGGGATGGAGAAGGACCAAGTACAGCCGTAAAACTCCAC
SCA6	CCGGCCACCGGGCCCCGCCGTGTCGACAGGCCCTGGGGGACTCGCTCCGGGCCGGGCCTGGGACCCGCCTCTCCATCCTGGGCGAGCGGCCGCTGCTGTGGCCCCCCGTGGGCGGCCGATCTCCGGCCAGAGGCTCGGCCGTGGGGCCTGGGTACCTCCGAGGGCCGCTGGTGGCCGCCCGGCCCGGCCTGGCCACCGCC	CTG	CGGGGGCCCCGAGCCGCCGGCCTTACGGATCACAGGGGAATAGGACACGTGTGGCCGGGGGGTGGAGGGGGTCTGGGGGAGCTGGCGGCGGCCCCGCCGCGGAGTGCTGGTACCAGATGTTGAGGGGGCTGGGCTTCCACTTACGGAACTACTGCCCTACACGAAAATTGAAACAAAGGAAATCAAAAAAAAAGATACAA
OPDM2	GGAAGGGAGCTGCCCCCACCACCCCCCACCCCCGCTTCCCCTGGGAAGGGGCCTCCGGCATCCCCGCGCGCAGCCTAGACCTCCAGTCGCGTCCACGGCGCCGGCCCCACCCTGCAGGATCGGCCGGATCCTCGCAGGCCCGCGACCCCCGAGGCCCCCGGAGCAGACACATCCTTCTCGCAGAGGCCACTCACCTGCTC	CCG	TCCCCGTGCGCACCCGGCTCGGCCCTCCGCAAACTCCAGACCGGGCCTCTCCCGCAGCGGCGCCTGGGGGGCGGGGCCGACGCCCGCGGCCGGCCAATCAGCGGCTGCCTCTCGGTGCTCGCAGCCAATCCGCGTCTTCCGCTTCGGGTGGACCCGACGGAAACATTCCAGAGGGATCCCTCCGCCTCGCCCGGCTCTTC
PSACH.MED	GTCGCCCACGCCGTCCCCTGAGAGGTGGGAGACCCCTCGGTGGGCTAAAGTCAGGGCCCGCCCACCGTAGACCCCGCGCCAGGAGCCCCCACTGGCCCCGCCCCCACCGCAGGCCCCGCCCCCGCCGTACTGTCCGCGTCCTCCTGGCCGGGGTTAGGCACCAGGCGGCAGTTGTCCCGACTGTCAGGGACTCCGTCATT	CGT	GCAGGCATCACCCTGGCCATCGTGGTCTGAGTCCTCCTGGGCACTGTTAGGCACCGTGGGACAGTTGTCCCGAGAGTCCTGATGTCCGTCTCCATCCCTAGAGTGGATAGGTGGGATCCAGAGACAATGAGCTCTCCAGAGCGTTTTGTCAAAGGCTACCCGGACGCCCACCCCAGGTGGCCTCCTTACTGGTCTTGATC
DM1	GCAGAGATCGCGCCAGACGCTCCCCAGAGCAGGGCGTCATGCACAAGAAAGCTTTGCACTTTGCGAACCAACGATAGGTGGGGGTGCGTGGAGGATGGAACACGGACGGCCCGGCTTGCTGCCTTCCCAGGCCTGCAGTTTGCCCATCCACGTCAGGGCCTCAGCCTGGCCGAAAGAAAGAAATGGTCTGTGATCCCCCC	CAG	CATTCCCGGCTACAAGGACCCTTCGAGCCCCGTTCGCCGGCCGCGGACCCGGCCCCTCCCTCCCCGGCCGCTAGGGGGCGGGCCCGGATCACAGGACTGGAGCTGGGCGGAGACCCACGCTCGGAGCGGTTGTGAACTGGCAGGCGGTGGGCGCGGCTTCTGTGCCGTGCCCCGGGCACTCAGTCTTCCAACGGGGCCCC
SCA36	AAGGCCGGAGATGGTGTCGTCCCCGGCCTCCGATTGGTCGGGGGGGCGGGGGCGTGGCCTCTGGAGCCTGGTTCCGCGCGCCGGAGCGCGCTAGCCGCATTGCGAGCCGAACCCGGGAGCTGGCGCCATGGTGAGGAGTGGTTGCGGGGCGCGGGCGACGCGACGGTGGGGGTTTCGGCCTGCGTTCGGGCCGCAGACAG	GGCCTG	CCCTGGGAACGGGTTCCGGCAGACGCTGAGGTTGCGTTGACGCTCGCGCCCCGGCTCCCGTTCCAGGTGCTGTTGCACGTGCTGTTTGAGCACGCGGTCGGCTACGCGCTGCTGGCGCTGAAGGAAGTGGAGGAGATCAGTCTGCTGCAGCCGCAGGTGGGTGAGATCCGTGGGCTCCTTTGGCGGCCCCGCAGACCCTC
EPM1	TGGCGGAGGGCGCCCCGCACATCATCTTGGCGGCGACGGAGGGAATCTGGCGAGGGGACTCGGCGAGGGGACGCGGCGGCTCCTCAGCCCAAGTAGGCGCTGGGGTCACGTGACGCGCGGGCGGAACCAAGGGGCGGGGAGGAGGCACTTTGGCTTCGGAGTCCCCTGCGGGGTCGCGGTGGCCCCGCAAGAAGGGACGC	GCGCGGGGCGGG	AACCTGGCCACCACTCGCCGCAGGCTGGGTCTCCGCGCCCAGCGCTGGTGTCGGGAGGGAGCGCCCCCCTCCCGGGGCTGGTATCGTCTTTCCGGGCGCCGAGTCACACGGACCGGGGCGGGGGCGCGGCCGGGTGTCGCCGGTGGGTTGGGCGCGCAGGGTGGGACGATAGGGAAGGGGCAGTCGGAGTAGGCGCAATC
TOF	CCCCGAACCCCGAGCTGCGCCTGGAGGCGCCCGGCGCATCGGAGCCGCTGCACCACCACCCCTACAAATATCCGGCCGCCGCCTACGACCACTATCTCGGGGCCAAGAGCCGGCCGGCGCCCTACCCGCTGCCCGGCCTGCGTGGCCACGGCTACCACCCGCACGCGCATCCGCACCACCACCACCACCCCGTGAGTCCA	GCC	AACATGTACTCGTCGGCCGGAGCCGCGCCGCCCGGCTCCTACGACTATTGCCCCAGATAACACGGGCCCTGTCGCGCTCCCGCCCCGGTCCTGCACAGCCCCGAAGTTCGCCGGGCCCGGCCACCCTGCCCCAAGGGCAAGCAAGGAATACGTTCCCCCAGCCCCAGGGGCCACCGCGGCTCTCCCCTTCCCCAGCCTCG
SCA10	GAGAGACAGTTAACAAGCCAGTATTGGAGAAATAAGTGGAATATTTAAAAATGCTCAGTCTCAAAAGAGTCTGGAAAATAAGAACAAAGAATAGTGAAGACAAATAGAAAACAGATGGCAGAATGATAAACTCAATCATGTTGATAAATATATTAAATGTAAATGGCTTAAATATCCAACTAAAAGACTACTAGAATGGA	ATTCT	TTTGAGATGAAGTCTCTCTATGTTGCCCAGGCTGGAGTGCAGTGGCGCGATCTCAGCTCACTGCAACCTCTGCCTACCAGGTTCAAGCAATTCTCCTGCCTCAGCCTCCCAAGTAGCTGAGATTACAGGTTCACCACCACACCCAGCTAATTTTTGTATTTTTAGTAGAGACGGTGTTTCGGGAAGTCAGGGACCCTGAA
XLID	CGCCCCGTTCTCGCGGTACGACTTGCTGCGGCTGATGCTCACCTGCGGCGCCTGGCTGATCTTGAGCGTGTCCCAGGCCGCGGCGGCCGCGGCCGCGGCTGCCGCGGCGGCCCCTGCGCCGTCCGGCCGTTCCCCGGGCCGCGCGGTTGGCGGTGGCGGCGGAGGGGCCTCCCCGCGTGGACCCGCCGTGGCCGTGGCGG	GCC	ACCCTGAAGGAGGCGGCCCCCGCCCGGGCCGTACAGGCGCCGCAGCTTGGGCGGCAGGTGCAGCTCGGCCTCGAACGGGGCGCTGCTGCTCTTAGGGGAGCCTGCGGGCAAGGGAGAGCTATCAGCCAGCCGGCCGGCCGGGGAGTCCCAGCCAGGGCTGCTGCCGGGGCCCGCCCGCAGTTGCTCCCCCAGTGCCTAGG
DMD	AAGAATCCTTGGTGATAGGATCTTCAGACAGAGAGGCTCTAGGGACTTGAAACCTGGAAGTTCAGCATAGGCATTTAGTATATGTTGAGCCTTAGGGAACTCATTTATCAATTTGATATCACTCCTTTGTATCACTGCCATGGTGAATGATCAGAAAGGAAACACAAACTCCTTCTTTAAGAACTGCAATAACGAACTGT	TTC	TTTTTTTTGGCAGAGGTGGGGTGTCTCGCTACCTTGACTAGGCAGGTCTTGAACTGCTGGCCTCAAGCAATGCTCCCACCTCAGCCTCCCAAAGTGTTCGGATAACCGGCATTAGCCACCTCCTCTGGCCAAGAACTGTTTCTTTTGATTAAATTTTGTTCTTCCTACTCCAACTTTCCTTAAAGATAATGCTTCCTTAA
SBMA	GTAGGTGGAAGATTCAGCCAAGCTCAAGGATGGAAGTGCAGTTAGGGCTGGGAAGGGTCTACCCTCGGCCGCCGTCCAAGACCTACCGAGGAGCTTTCCAGAATCTGTTCCAGAGCGTGCGCGAAGTGATCCAGAACCCGGGCCCCAGGCACCCAGAGGCCGCGAGCGCAGCACCTCCCGGCGCCAGTTTGCTGCTGCTG	CAG	GGTGAGGATGGTTCTCCCCAAGCCCATCGTAGAGGCCCCACAGGCTACCTGGTCCTGGATGAGGAACAGCAACCTTCACAGCCGCAGTCGGCCCTGGAGTGCCACCCCGAGAGAGGTTGCGTCCCAGAGCCTGGAGCCGCCGTGGCCGCCAGCAAGGGGCTGCCGCAGCAGCTGCCAGCACCTCCGGACGAGGATGACTC
XDP	GGAGACCAGCCCGGCCAACACAGCGAAACCCGGTCTCCACCAAAAAAATACGAAAACCAGTCAGGCGTGGTGGCGCGCGCCTGCAATCGCAGGCACTCGGCAGGCTGAGGCAGGAGAATCAGGCAGGCAGGTTGCAGTGAGCCGAGATGGCAGCAGCACAGTCCAGCTTCGGCTCGGCATCAGAGGGAGACCGTGGAAAG	GAGAGG	AGGAATTCTGTCTTACTCCAGACCAGTTGGTTTGTTTTTAGAGCAGCTTTAGTTCATGGCAAAATTGAGCAGAAGTTACAGAGAGTTCCCATATACTCCCTGCCCTCACATACATACAGCCTCCCCAGTTATCAACATCTTGCACCAGGCTGGGCGTTGTGGCTCACGCCTGTAATCCCAGCACTTTGGGAAGCCAAGGT
XH	GCGGCATCATTGGGCTGTACTGCAGGCCGGCCATGTCGTAGCGGTGCATCGGCGGCAGCGCGGGCGGCGGCGGCGGGCTGCTCATGCTCGGGGGCTGCGCGTAGCCCAGCTGCTCCTGCACCAGCGAGTACGCGCCGTTGGCCCAGCCGTTCACGTGCGTGTACGTGTCCAGGCGCTGGCCCACGCCCACCGGACTGCTG	GCN	TGGGCAGGGAGTACTTATCTTTCTTGAGCAGCGTCTTGGTCTTGCGGCGCGGTCGGTACTTGTAGTCCGGATACTCCTTCATGTGCACGGCGCGAAGTCGCTTGGCCTCGTCGATGAATGGTCGCTTCTCGGCGTCGGTCAGCAGTTTCCAGTCGGCGCCCAAGCGCTTGCTGATCTCAGAATTGTGCATCTTGGGGTTC
FXS	TGAGCCCGCGGGGGGAGGGAACAGCGTTGATCACGTGACGTGGTTTCAGTGTTTACACCCGCAGCGGGCCGGGGGTTCGGCCTCAGTCAGGCGCTCAGCTCCGTTTCGGTTTCACTTCCGGTGGAGGGCCGCCTCTGAGCGGGCGGCGGGCCGACGGCGAGCGCGGGCGGCGGCGGTGACGGAGGCGCCGCTGCCAGGGG	CGG	TGGGCCTCGAGCGCCCGCAGCCCACCTCTCGGGGGCGGGCTCCCGGCGCTAGCAGGGCTGAAGAGAAGATGGAGGAGCTGGTGGTGGAAGTGCGGGGCTCCAATGGCGCTTTCTACAAGGTACTTGGCTCTAGGGCAGGCCCCATCTTCGCCCTTCCTTCCCTCCCTTTTCTTCTTGGTGTCGGCGGGAGGCAGGCCCGG
FRAXE	CCGGGTCCGGGTCCGGGTCCTCAGCTCTGTGGCCGCTCCCACTAGCTGATTTTGACAGTGGGGGGTGGGAGAGGGTTCCCGAAAGGCAGGGGCGGGCGCGGCGAGCCCCTGCCAGATCCGGGGATGATAACGTGCCTGCTCCATGTCGCGGCTTCTAGCTGTCCAGGCTCCGCCCCCTGTGAGTGTGTAAGTGTGTGATG	CCG	GCCGCCGCCGGCCCGCAGCCAGCCAGGCGGGCGGCCCAGCCCGCCTGAGCCCGCAGCGGCTGCCGCCGCAGCGTCGGGTCGCTGGGTGCGCGGGCTACCGCGGACCGAGCGGACCCGAGTGGGCGACCAGGCGCTTGCCCGCCCAGTGCCACTGCCGCCGCTTCCTCGCCGGAGCACAGGACCAGACACCTCCAGCGCCC
